1111111111111111111111111111111111111111
S000100010001000100000001000000000100001
1010101010101010101111101011111110101111
1010101010101010101000101010000010100011
1010101010101010101010101010111010111011
1010001010001000101010101010100010100011
1011101011111011101010101010101110101111
1000101010000010001010101010100010100001
1110101010111110111010101010111010111111
1000101010100000100010101010100010100001
1011101010101111101110101010101110101111
1010001010101000000010101010100010100011
1010111010101011111110101010111010111011
1010100010101010000000101010100010100011
1010101110101010111111101000101110101111
1010100000101010100000001010100010100001
1010111111101010101011111010111010111111
1010000000001010101000000010100010000011
1011111111111010101011111010101111111011
1000000000000010101010000000100000001011
1111011111111110101010111111111111101011
1000000000000000001010100000000000101011
1011111111111111101010101111111110101011
1010000000000000001010100000000010101011
1010111111111111111010111111111010101011
1010100000000000000010000000001010101011
1010101111111111111111111111101010101011
1010101000000000000000000000101010101011
1010101011111111111111111110101010101011
1010101010000000000000000010101010101011
1010101010111111111111111010101010101011
1010101010100000000000001010101010101011
1010101010101111111111101010101010101011
1010101010101000000000101010101010101011
1010101010101011111110101010101010101011
1010101010101010000010101010101010101011
1010101010101010111010101010101010101011
1010101010101010100010101010101010101011
1010101010101010111110101010101010101011
1000101010101010000000101010101010100011
11111E1111111111111111111111111111111111