111111111111111111111
S00000000111111111101
111011110100000000101
100010000101111110101
101111110101000010101
100000010101011110101
111110010101000000101
100010010111011111101
101010010000010000101
101011111101110111101
100000000000010100101
111111111110010101101
100000000010010100101
101111111011010101101
100000001010010101101
111110101010010101101
100000101000010001101
101111101111111101101
100000000000000000001
1111111111111111111E1
