1111111111111111111111111111111111111111
1000000000100000000010000000000000000001
1011111110101111111010111111111111111101
1010000010101000001010100000000000000101
1010111010101011101010101111111111110101
1010101010101010101010101000000000010101
1010101010101010101010101011111111010101
1010101010101010101010101010000001010101
1010101010101010101010101010111101010101
1010101010101010101010101010100001010101
1010101010101010101010101010101111010101
1010101010101010101010101010100001010101
1010101010101010101010101010111101010101
S01010101010101010101010101000000101010E
1010101010101010101010101011111111010101
1010101010101010101010101000000000010101
1010101010101010101010101111111111110101
1010101010101010101010100000000000000101
1010101010101010101010111111111111111101
1010101010101010101010000000000000000001
1010101010101010101011111111111111111101
1010101010101010101000000000000000000101
1010101010101010101111111111111111110101
1010101010101010100000000000000000000101
1010101010101010111111111111111111111101
1010101010101010000000000000000000000001
1010101010101011111111111111111111111101
1010101010101000000000000000000000000101
1010101010101111111111111111111111110101
1010101010100000000000000000000000000101
1010101010111111111111111111111111111101
1010101010000000000000000000000000000001
1010101011111111111111111111111111111101
1010101000000000000000000000000000000101
1010101111111111111111111111111111110101
1010100000000000000000000000000000000101
1010111111111111111111111111111111111101
1010000000000000000000000000000000000001
1011111111111111111111111111111111111111
1000000000000000000000000000000000000001
1111111111111111111111111111111111111111